##########
##########
##########
##########
OOOOBOOOOO
##########
##########
#P####T###
##########
##########