##########
##########
##########
##########
OOOOBOOOOO
##########
##########
#P########
##########
##########